R 1280 720

NO ./Texture/redbrick.xpm
SO ./Texture/tile2.xpm
WE ./Texture/eagle.xpm
EA ./Texture/tile4.xpm
S ./Texture/barrel.xpm

F 0,0,0
C 255,255,255

          111111
1111111111010001
1000020000102001
1000000000000001
1000020001111111
1111111111
    11        
    101
 11111111        1  
  100200011111  101
 10020011      1001
1000000111    1011
111100S020111111111
    100002000001
111111111111111111
   101
    1
    