R 1920 1080

NO ./Texture/gray_tile.xpm
SO ./Texture/green_tile.xpm
WE ./Texture/moss_tile.xpm
EA ./Texture/purple_tile.xpm
S ./Texture/cat1.xpm

F 220,100,0
C 225,30,0

        1111111111111111111111111
        1000000000110000000000001
        1011000001110000002000001
        1001000000000000000000001
111111111011000001110000000000001
100000000011000001110111111111111
11110111111111011100000010001
11110111111111011101010010001
11000000110101011100000010001
10002000000000001100000010001
10000000000000001101010010001111
110000011101010111110111101111N0111
11110111 1110101 1011110100011111
11111111 1111111 111111111111
